abcdefghijklmnopqrstuvwxyz
ABCDEFGHIJKLMNOPQRSTUVWXYZ
12345678912345678912345678
..........................
§§§§§§§§§§§§§§§§§§§§§§§§§§
!!!!!!!!!!!!!!!!!!!!!!!!!!
;;;;;;;;;;;;;;;;;;;;;;;;;;
??????????????????????????